"ad" = (/obj/structure/sink{dir = 1; pixel_y = -10},/turf/open/floor/almayer{dir = 10; icon_state = "green"; tag = "icon-green (SOUTHWEST)"},/area/space)
"aC" = (/turf/closed/shuttle/escapepod{icon_state = "wall4"; tag = "icon-wall4"},/area/space)
"aD" = (/obj/structure/machinery/vending/security,/turf/open/floor/almayer{icon_state = "plate"; tag = "icon-sterile"},/area/space)
"aE" = (/obj/structure/disposalpipe/segment{dir = 4},/obj/structure/pipes/standard/simple/hidden/supply{dir = 4; tag = "icon-intact-supply (EAST)"},/turf/open/floor/plating/plating_catwalk,/area/space)
"bx" = (/turf/closed/shuttle/escapepod{icon_state = "wall9"; tag = "icon-wall9"},/area/space)
"bz" = (/obj/structure/closet{name = "Technician's Locker"},/obj/item/clothing/under/marine/officer/engi,/obj/item/clothing/accessory/ranks/marine/e4,/obj/item/clothing/accessory/patch/falcon,/obj/item/clothing/suit/storage/marine/light/vest,/turf/open/floor/plating/plating_catwalk,/area/space)
"cI" = (/obj/structure/machinery/portable_atmospherics/hydroponics,/obj/structure/machinery/firealarm{pixel_y = 28},/turf/open/floor/almayer{dir = 1; icon_state = "green"; tag = "icon-green (NORTH)"},/area/space)
"cN" = (/obj/structure/machinery/door/airlock/almayer/secure{name = "\improper Evacuation Airlock PL-3"; req_access = null},/turf/open/floor/almayer,/area/space)
"cZ" = (/turf/closed/shuttle/escapepod{icon_state = "wall13"; tag = "icon-wall13"},/area/space)
"ed" = (/obj/structure/bed/chair{dir = 4; pixel_x = -9},/turf/open/floor/plating/plating_catwalk,/area/space)
"fC" = (/obj/item/trash/cigbutt,/obj/item/trash/cigbutt{pixel_x = -1; pixel_y = 17},/obj/item/trash/cigbutt{pixel_x = -9; pixel_y = -6},/obj/item/trash/cigbutt{pixel_x = 1; pixel_y = 8},/obj/item/trash/cigbutt{pixel_x = -10; pixel_y = 13},/obj/item/trash/cigbutt{pixel_x = 4},/obj/item/trash/cigbutt{pixel_x = -7; pixel_y = 13},/obj/item/trash/uscm_mre{pixel_x = 12; pixel_y = -7},/obj/structure/sign/poster{icon_state = "poster10"; pixel_y = 32},/obj/item/trash/uscm_mre{pixel_x = -10; pixel_y = 2},/turf/open/floor/plating/plating_catwalk,/area/space)
"fW" = (/obj/structure/reagent_dispensers/watertank,/turf/open/floor/almayer{dir = 6; icon_state = "green"; tag = "icon-green (SOUTHEAST)"},/area/space)
"gl" = (/obj/structure/barricade/wooden{dir = 1; layer = 3.0; pixel_y = 17},/obj/structure/janitorialcart,/turf/open/floor/almayer{icon_state = "plate"; tag = "icon-sterile"},/area/space)
"hh" = (/obj/structure/machinery/portable_atmospherics/hydroponics,/obj/structure/machinery/door_control{id = "kitchenhydro"; name = "Kitchen Hydroponics Shutters"; pixel_y = 25; req_access = null},/turf/open/floor/almayer{dir = 9; icon_state = "green"; tag = "icon-green (NORTHWEST)"},/area/space)
"hz" = (/obj/structure/machinery/portable_atmospherics/hydroponics,/obj/structure/machinery/light,/turf/open/floor/almayer{icon_state = "green"; tag = "icon-green"},/area/space)
"ie" = (/obj/item/trash/barcardine{pixel_y = 15},/turf/open/floor/plating/plating_catwalk,/area/space)
"ja" = (/obj/structure/machinery/door/airlock/almayer/generic{dir = 1; name = "Kitchen Hydroponics"; req_access_txt = "30"},/obj/structure/disposalpipe/segment,/obj/structure/pipes/standard/simple/hidden/supply,/turf/open/floor/almayer{icon_state = "plate"; tag = "icon-sterile"},/area/space)
"kC" = (/obj/structure/window/framed/almayer,/obj/structure/machinery/door/poddoor/shutters/almayer{dir = 4; id = "bot_armory"; name = "\improper Armory Shutters"},/turf/open/floor/plating,/area/space)
"kF" = (/obj/structure/surface/rack,/obj/item/stack/sheet/cardboard{amount = 50; pixel_x = -3},/obj/item/stack/sheet/cardboard{amount = 50; pixel_x = 4},/turf/open/floor/almayer{icon_state = "plate"; tag = "icon-sterile"},/area/space)
"lr" = (/obj/structure/largecrate/random/secure,/obj/item/ammo_box/magazine/m44/heavy/empty{layer = 3.0; pixel_y = 10},/turf/open/floor/plating/plating_catwalk,/area/space)
"mg" = (/obj/item/reagent_container/hypospray/autoinjector/bicaridine,/turf/closed/shuttle/escapepod{icon_state = "wall8"; tag = "icon-wall8"},/area/space)
"mL" = (/obj/structure/barricade/wooden{dir = 4},/obj/structure/largecrate/random/barrel/red{pixel_x = -4},/turf/open/floor/plating/plating_catwalk,/area/space)
"nd" = (/turf/closed/shuttle/escapepod{icon_state = "wall2"; tag = "icon-wall2"},/area/space)
"nn" = (/turf/open/shuttle/escapepod{icon_state = "floor12"; tag = "icon-floor12"},/area/space)
"nW" = (/obj/structure/closet/secure_closet/guncabinet/blue{name = "sidearm storage"},/obj/item/ammo_magazine/pistol,/obj/item/ammo_magazine/pistol,/obj/item/ammo_magazine/pistol,/obj/item/ammo_magazine/pistol,/obj/item/ammo_magazine/pistol,/obj/item/ammo_magazine/pistol,/obj/item/ammo_magazine/pistol,/obj/item/ammo_magazine/pistol,/obj/item/ammo_magazine/pistol,/obj/item/ammo_magazine/pistol,/obj/item/weapon/gun/pistol/m4a3,/obj/item/weapon/gun/pistol/m4a3,/obj/item/weapon/gun/pistol/m4a3,/turf/open/floor/almayer{dir = 5; icon_state = "plating"; tag = "icon-blue (NORTHEAST)"},/area/space)
"oS" = (/obj/structure/surface/table/almayer,/obj/item/storage/box/handcuffs{pixel_x = 4; pixel_y = 4},/turf/open/floor/plating/almayer,/area/space)
"pd" = (/obj/structure/machinery/vending/cigarette,/turf/open/floor/plating/plating_catwalk,/area/space)
"pE" = (/obj/structure/machinery/light/small{dir = 8},/obj/structure/barricade/deployable{dir = 1},/turf/open/floor/almayer{icon_state = "plate"; tag = "icon-sterile"},/area/space)
"pH" = (/obj/structure/window/framed/almayer,/obj/structure/machinery/door/poddoor/shutters/almayer{id = "kitchenhydro"; name = "\improper Kitchen Hydroponics Shutters"},/turf/open/floor/almayer{icon_state = "plate"; tag = "icon-sterile"},/area/space)
"pI" = (/turf/closed/shuttle/escapepod{icon_state = "wall6"; tag = "icon-wall6"},/area/space)
"qI" = (/obj/structure/closet/secure_closet/guncabinet/blue{name = "sidearm storage"},/obj/item/ammo_magazine/pistol,/obj/item/ammo_magazine/pistol,/obj/item/ammo_magazine/pistol,/obj/item/ammo_magazine/pistol,/obj/item/ammo_magazine/pistol,/obj/item/ammo_magazine/pistol,/obj/item/ammo_magazine/pistol,/obj/item/ammo_magazine/pistol,/obj/item/ammo_magazine/pistol,/obj/item/ammo_magazine/pistol,/obj/item/weapon/gun/pistol/m4a3,/obj/item/weapon/gun/pistol/m4a3,/obj/item/weapon/gun/pistol/m4a3,/obj/structure/machinery/light{dir = 8},/turf/open/floor/almayer{dir = 5; icon_state = "plating"; tag = "icon-blue (NORTHEAST)"},/area/space)
"qO" = (/turf/open/shuttle/escapepod{icon_state = "floor5"; tag = "icon-floor5"},/area/space)
"qP" = (/obj/effect/decal/warning_stripes{icon_state = "S"; tag = "icon-S"},/turf/open/floor/almayer{dir = 5; icon_state = "plating"; tag = "icon-blue (NORTHEAST)"},/area/space)
"qY" = (/obj/structure/disposalpipe/segment{dir = 4},/obj/structure/pipes/standard/simple/hidden/supply{dir = 10; tag = "icon-intact-supply (SOUTHWEST)"},/turf/open/floor/almayer,/area/space)
"rl" = (/obj/structure/machinery/washing_machine,/obj/structure/machinery/light/small{dir = 4},/turf/open/floor/almayer{icon_state = "plate"; tag = "icon-sterile"},/area/space)
"ru" = (/obj/structure/disposalpipe/segment{dir = 1; icon_state = "pipe-c"},/obj/structure/pipes/standard/simple/hidden/supply{dir = 5; tag = "icon-intact-supply (EAST)"},/turf/open/floor/almayer{dir = 8; icon_state = "green"; tag = "icon-green (WEST)"},/area/space)
"rJ" = (/obj/structure/machinery/camera/autoname/almayer{dir = 1; name = "ship-grade camera"; tag = "icon-camera (NORTH)"},/turf/open/floor/almayer{dir = 10; icon_state = "red"; tag = "icon-red (SOUTHWEST)"},/area/space)
"se" = (/turf/open/floor/almayer{dir = 8; icon_state = "green"; tag = "icon-green (WEST)"},/area/space)
"sg" = (/obj/structure/largecrate/random/case/small{pixel_y = 11},/obj/item/ammo_box/magazine/misc/mre/empty{layer = 3.0; pixel_x = 8},/obj/item/ammo_box/magazine/misc/mre{layer = 3.0; pixel_x = -6},/turf/open/floor/plating/plating_catwalk,/area/space)
"to" = (/obj/structure/surface/table/almayer{dir = 1; flipped = 1},/turf/open/floor/almayer{icon_state = "plate"; tag = "icon-sterile"},/area/space)
"ts" = (/obj/structure/largecrate/random/secure,/turf/open/floor/plating/plating_catwalk,/area/space)
"tN" = (/obj/structure/machinery/light/small,/obj/structure/barricade/metal{dir = 4},/turf/open/floor/plating/plating_catwalk,/area/space)
"ur" = (/turf/open/floor/almayer{dir = 8; icon_state = "red"; tag = "icon-red (WEST)"},/area/space)
"uy" = (/turf/open/shuttle/escapepod{icon_state = "floor4"; tag = "icon-floor4"},/area/space)
"vO" = (/obj/structure/surface/rack,/obj/item/tool/shovel/spade{pixel_x = -4},/obj/item/tool/shovel/spade{pixel_x = 4},/obj/item/tool/shovel/spade,/obj/item/reagent_container/glass/bucket{pixel_x = -4; pixel_y = -3},/obj/item/reagent_container/glass/bucket{pixel_x = 4; pixel_y = -3},/obj/item/reagent_container/glass/bucket,/obj/structure/machinery/light{dir = 8},/turf/open/floor/almayer{icon_state = "plate"; tag = "icon-sterile"},/area/space)
"vZ" = (/obj/structure/machinery/vending/hydronutrients,/obj/structure/machinery/light{dir = 4},/turf/open/floor/almayer{dir = 4; icon_state = "green"; tag = "icon-green (EAST)"},/area/space)
"xM" = (/obj/structure/surface/table/almayer{dir = 1; flipped = 1},/turf/open/floor/plating/plating_catwalk,/area/space)
"xQ" = (/obj/structure/machinery/door/airlock/evacuation{name = "\improper Evacuation Airlock PL-3"},/turf/open/floor/plating,/area/space)
"yp" = (/obj/structure/machinery/light/small{dir = 1; tag = "icon-bulb1 (NORTH)"},/turf/open/floor/plating/plating_catwalk,/area/space)
"yA" = (/obj/structure/surface/rack,/obj/item/tool/minihoe{pixel_x = -4},/obj/item/tool/minihoe{pixel_x = 4},/obj/item/tool/minihoe{pixel_y = -4},/obj/item/tool/wirecutters/clippers{pixel_y = -4},/obj/item/tool/wirecutters/clippers{pixel_y = -2},/obj/item/tool/wirecutters/clippers,/turf/open/floor/almayer{icon_state = "plate"; tag = "icon-sterile"},/area/space)
"zb" = (/obj/structure/disposalpipe/segment,/obj/structure/pipes/standard/simple/hidden/supply,/turf/open/floor/almayer{dir = 9; icon_state = "green"; tag = "icon-green (NORTHWEST)"},/area/space)
"zc" = (/obj/structure/largecrate/random/barrel/green,/turf/open/floor/plating/plating_catwalk,/area/space)
"zC" = (/obj/structure/pipes/vents/pump{dir = 1},/turf/open/floor/almayer,/area/space)
"zZ" = (/obj/structure/surface/table/almayer,/obj/structure/machinery/reagentgrinder{pixel_y = 3},/turf/open/floor/almayer{icon_state = "plate"; tag = "icon-sterile"},/area/space)
"AA" = (/obj/structure/surface/table/almayer,/obj/item/storage/box/handcuffs{pixel_x = 4; pixel_y = 4},/obj/structure/machinery/cm_vending/sorted/medical/wall_med{pixel_y = 25},/turf/open/floor/plating/almayer,/area/space)
"Bk" = (/obj/structure/largecrate/random/case/double,/turf/open/floor/plating/plating_catwalk,/area/space)
"BZ" = (/turf/closed/shuttle/escapepod{icon_state = "wall10"; tag = "icon-wall10"},/area/space)
"CK" = (/obj/structure/bedsheetbin,/turf/open/floor/plating/plating_catwalk,/area/space)
"CP" = (/obj/structure/machinery/light/small,/obj/structure/barricade/plasteel{dir = 8},/turf/open/floor/plating/plating_catwalk,/area/space)
"Db" = (/obj/structure/reagent_dispensers/peppertank{pixel_x = -30},/obj/effect/decal/warning_stripes{icon_state = "S"; tag = "icon-S"},/turf/open/floor/almayer{dir = 5; icon_state = "plating"; tag = "icon-blue (NORTHEAST)"},/area/space)
"Eg" = (/obj/structure/pipes/vents/scrubber{dir = 1},/turf/open/floor/almayer,/area/space)
"Ew" = (/turf/open/floor/almayer{dir = 9; icon_state = "red"; tag = "icon-red (NORTHWEST)"},/area/space)
"EA" = (/turf/open/floor/plating/plating_catwalk,/area/space)
"FM" = (/obj/structure/machinery/portable_atmospherics/hydroponics,/turf/open/floor/almayer{icon_state = "green"; tag = "icon-green"},/area/space)
"Gp" = (/obj/structure/surface/table/almayer,/obj/item/storage/fancy/cigarettes/emeraldgreen{pixel_x = -10; pixel_y = 13},/obj/item/reagent_container/food/drinks/flask/marine{pixel_x = 10; pixel_y = 11},/obj/item/trash/USCMtray{pixel_y = 2},/turf/open/floor/almayer{icon_state = "plate"; tag = "icon-sterile"},/area/space)
"GH" = (/turf/closed/shuttle/escapepod{icon_state = "wall3"; tag = "icon-wall3"},/area/space)
"Id" = (/obj/structure/closet/secure_closet/guncabinet/red,/obj/item/ammo_magazine/shotgun,/obj/item/ammo_magazine/shotgun,/obj/item/ammo_magazine/shotgun,/obj/item/ammo_magazine/shotgun/buckshot,/obj/item/ammo_magazine/shotgun/buckshot,/obj/item/ammo_magazine/shotgun/buckshot,/obj/item/weapon/gun/shotgun/combat,/obj/item/weapon/gun/shotgun/combat,/obj/item/weapon/gun/shotgun/combat,/turf/open/floor/plating/almayer,/area/space)
"IF" = (/obj/item/tool/mop{pixel_x = -6; pixel_y = 14},/turf/open/floor/almayer{icon_state = "plate"; tag = "icon-sterile"},/area/space)
"Jo" = (/obj/structure/largecrate/supply{pixel_x = 6},/obj/structure/largecrate/random/mini/ammo{pixel_x = 5; pixel_y = 12},/obj/structure/barricade/deployable{dir = 8},/turf/open/floor/plating/plating_catwalk,/area/space)
"Jx" = (/obj/structure/machinery/door/airlock/almayer/security/glass{dir = 2; name = "\improper Security Lockers"},/turf/open/floor/almayer{icon_state = "redfull"; tag = "icon-redfull"},/area/space)
"JF" = (/obj/structure/surface/table/almayer,/obj/item/storage/firstaid/adv{pixel_x = 6; pixel_y = 6},/obj/item/storage/box/flashbangs,/obj/item/storage/box/flashbangs,/obj/item/storage/box/flashbangs,/obj/structure/machinery/firealarm{pixel_y = 28},/turf/open/floor/plating/almayer,/area/space)
"KN" = (/obj/item/tool/crowbar,/turf/open/floor/plating/plating_catwalk,/area/space)
"LF" = (/obj/structure/barricade/metal{dir = 1},/turf/open/floor/almayer{icon_state = "plate"; tag = "icon-sterile"},/area/space)
"LI" = (/obj/structure/machinery/cryopod/evacuation,/turf/open/shuttle/escapepod,/area/space)
"LU" = (/obj/structure/machinery/disposal,/obj/structure/disposalpipe/trunk,/turf/open/floor/almayer{dir = 1; icon_state = "green"; tag = "icon-green (NORTH)"},/area/space)
"Mc" = (/turf/closed/wall/almayer,/area/space)
"Ml" = (/obj/structure/machinery/cm_vending/clothing/dress,/turf/open/floor/almayer{icon_state = "plate"; tag = "icon-sterile"},/area/space)
"Nm" = (/obj/structure/prop/invuln/overhead_pipe{pixel_x = 12},/turf/open/floor/almayer{icon_state = "plate"; tag = "icon-sterile"},/area/space)
"NU" = (/obj/structure/barricade/wooden{dir = 4},/turf/open/floor/plating/plating_catwalk,/area/space)
"Od" = (/obj/structure/closet/secure_closet/guncabinet/red,/obj/item/ammo_magazine/shotgun,/obj/item/ammo_magazine/shotgun,/obj/item/ammo_magazine/shotgun,/obj/item/ammo_magazine/shotgun/buckshot,/obj/item/ammo_magazine/shotgun/buckshot,/obj/item/ammo_magazine/shotgun/buckshot,/obj/item/weapon/gun/shotgun/combat,/obj/item/weapon/gun/shotgun/combat,/obj/structure/machinery/light/small{dir = 8; tag = "icon-bulb1 (WEST)"},/obj/item/weapon/gun/shotgun/combat,/obj/item/vehicle_clamp,/obj/item/vehicle_clamp,/obj/item/vehicle_clamp,/turf/open/floor/plating/almayer,/area/space)
"Or" = (/turf/open/floor/almayer{icon_state = "plate"; tag = "icon-sterile"},/area/space)
"OM" = (/turf/closed/shuttle/escapepod{icon_state = "wall1"; tag = "icon-wall1"},/area/space)
"OV" = (/obj/structure/sink{dir = 8; pixel_x = -12; pixel_y = 2},/obj/structure/closet/crate/trashcart,/turf/open/floor/almayer{icon_state = "plate"; tag = "icon-sterile"},/area/space)
"Pa" = (/turf/open/floor/almayer,/area/space)
"Pi" = (/obj/structure/largecrate/supply/supplies/water,/obj/item/weapon/gun/pistol/vp70{pixel_y = 8},/turf/open/floor/plating/plating_catwalk,/area/space)
"PJ" = (/obj/structure/machinery/floodlight,/turf/open/floor/almayer{dir = 5; icon_state = "green"; tag = "icon-green (NORTHEAST)"},/area/space)
"Qc" = (/obj/structure/prop/invuln/overhead_pipe{pixel_x = 12},/turf/open/floor/plating/plating_catwalk,/area/space)
"Sm" = (/obj/structure/machinery/vending/hydroseeds,/turf/open/floor/almayer{dir = 4; icon_state = "green"; tag = "icon-green (EAST)"},/area/space)
"SD" = (/obj/structure/disposalpipe/segment{dir = 8; icon_state = "pipe-c"},/turf/open/floor/plating/plating_catwalk,/area/space)
"TK" = (/obj/structure/disposalpipe/segment{dir = 4},/obj/structure/pipes/standard/manifold/hidden/supply{dir = 1},/turf/open/floor/almayer,/area/space)
"TU" = (/turf/closed/wall/almayer/outer,/area/space)
"Uz" = (/obj/structure/machinery/vending/security,/turf/open/floor/plating/almayer,/area/space)
"UJ" = (/obj/structure/machinery/door/airlock/almayer/security/glass{name = "\improper Millitary Police Armory"},/obj/structure/machinery/door/poddoor/shutters/almayer{dir = 4; id = "bot_armory"; name = "\improper Armory Shutters"},/turf/open/floor/plating,/area/space)
"UW" = (/obj/structure/machinery/door/airlock/almayer/maint{dir = 2},/turf/open/floor/almayer{icon_state = "plate"; tag = "icon-sterile"},/area/space)
"Ve" = (/obj/structure/closet/crate/ammo{pixel_y = 13},/obj/structure/largecrate/random/case/small,/obj/structure/largecrate/random/mini/med{pixel_y = 10},/turf/open/floor/plating/plating_catwalk,/area/space)
"VJ" = (/obj/structure/surface/rack,/obj/item/storage/bag/plants{pixel_x = -3},/obj/item/storage/bag/plants{pixel_x = 3},/obj/item/storage/bag/plants{pixel_y = -3},/turf/open/floor/almayer{icon_state = "plate"; tag = "icon-sterile"},/area/space)
"VN" = (/turf/closed/shuttle/escapepod{icon_state = "wall7"; tag = "icon-wall7"},/area/space)
"VO" = (/obj/structure/closet/secure_closet/guncabinet/riot_control,/obj/item/weapon/shield/riot,/obj/item/weapon/shield/riot,/obj/item/weapon/shield/riot,/turf/open/floor/plating/almayer,/area/space)
"VQ" = (/obj/structure/bed/chair{dir = 8; pixel_y = 3},/turf/open/floor/plating/plating_catwalk,/area/space)
"WH" = (/obj/structure/window/framed/almayer,/obj/structure/machinery/door/firedoor/border_only/almayer{dir = 2; tag = "icon-door_open"},/obj/structure/machinery/door/poddoor/shutters/almayer{id = "kitchenhydro"; name = "\improper Kitchen Hydroponics Shutters"},/turf/open/floor/almayer{icon_state = "plate"; tag = "icon-sterile"},/area/space)
"WQ" = (/obj/structure/machinery/vending/security,/obj/structure/reagent_dispensers/peppertank{pixel_x = -30},/turf/open/floor/almayer{icon_state = "plate"; tag = "icon-sterile"},/area/space)
"Xp" = (/turf/open/floor/almayer{dir = 5; icon_state = "plating"; tag = "icon-blue (NORTHEAST)"},/area/space)
"XR" = (/obj/structure/filingcabinet/seeds,/turf/open/floor/almayer{icon_state = "green"; tag = "icon-green"},/area/space)
"Yd" = (/obj/structure/machinery/door/airlock/almayer/maint{dir = 1},/turf/open/floor/almayer{icon_state = "test_floor4"},/area/space)
"YA" = (/obj/structure/closet/firecloset{pixel_x = 13},/obj/structure/bed/chair{dir = 8; pixel_x = -5; pixel_y = 3},/turf/open/floor/plating/plating_catwalk,/area/space)
"YY" = (/obj/structure/disposalpipe/segment{dir = 4},/obj/structure/pipes/standard/simple/hidden/supply{dir = 4; tag = "icon-intact-supply (EAST)"},/turf/open/floor/almayer,/area/space)
"ZW" = (/obj/structure/machinery/portable_atmospherics/hydroponics,/turf/open/floor/almayer{dir = 1; icon_state = "green"; tag = "icon-green (NORTH)"},/area/space)

(1,1,1) = {"
McMcMcMcMcMcpHjaMcWHWHWHMcWHWHWHMcMcUWMcMcMcMcMcMcMcMcJx
MccZOMndGHMcVJzbhhZWZWZWcIZWLUPJMcIFglkFMcoSAAUzJFkCMlEw
McBZuyLIaCMcvOruaETKaEYYaEqYSDvZMcOVzcrlMcnWXpXpXpkCMlur
cNxQqOLIaCMcyAseEAEgEAPaEAzCEASmMcpExMtoMcqIXpXpXpUJOrur
McBZnnLIaCMczZadhzFMFMFMFMhzXRfWMcOrOrOrMcDbqPqPqPMcWQur
McbxmgVNpIMcMcMcMcMcMcMcMcMcMcMcMcMcUWMcMcOdIdVOVOkCaDrJ
McMcMcMcMcMcGpVQfCsgbzEAypQcBkKNlrCKLFMcMcMcMcMcMcMcMcMc
JoPiedEAEACPieEAOrOrOrOrOrNmOrOrOrEAEAtNEAEANUpdVeYAtsmL
TUTUTUTUTUTUTUTUTUTUTUTUYdTUTUTUTUTUTUTUTUTUTUTUTUTUTUTU
"}
