"aD" = (/obj/structure/girder,/turf/open/floor/plating/almayer,/area/space)
"bz" = (/obj/structure/closet{name = "Technician's Locker"},/obj/item/clothing/under/marine/officer/engi,/obj/item/clothing/accessory/ranks/marine/e4,/obj/item/clothing/accessory/patch/falcon,/obj/item/clothing/suit/storage/marine/light/vest,/obj/item/clothing/accessory/storage/holster/armpit,/turf/open/floor/plating/plating_catwalk,/area/space)
"ed" = (/obj/structure/bed/chair{dir = 4; pixel_x = -9},/obj/item/storage/toolbox/electrical{pixel_y = 14},/turf/open/floor/plating/plating_catwalk,/area/space)
"fC" = (/obj/item/trash/cigbutt,/obj/item/trash/cigbutt{pixel_x = -1; pixel_y = 17},/obj/item/trash/cigbutt{pixel_x = -9; pixel_y = -6},/obj/item/trash/cigbutt{pixel_x = 1; pixel_y = 8},/obj/item/trash/cigbutt{pixel_x = -10; pixel_y = 13},/obj/item/trash/cigbutt{pixel_x = 4},/obj/item/trash/cigbutt{pixel_x = -7; pixel_y = 13},/obj/item/trash/uscm_mre{pixel_x = 12; pixel_y = -7},/obj/structure/sign/poster{icon_state = "poster10"; pixel_y = 32},/obj/item/trash/uscm_mre{pixel_x = -10; pixel_y = 2},/turf/open/floor/plating/plating_catwalk,/area/space)
"gl" = (/obj/structure/barricade/wooden{dir = 1; layer = 3.0; pixel_y = 17},/obj/structure/janitorialcart,/turf/open/floor/almayer{icon_state = "plate"; tag = "icon-sterile"},/area/space)
"ie" = (/obj/item/trash/barcardine{pixel_y = 15},/turf/open/floor/plating/plating_catwalk,/area/space)
"kC" = (/obj/structure/window/framed/almayer,/obj/structure/machinery/door/poddoor/shutters/almayer{dir = 4; id = "bot_armory"; name = "\improper Armory Shutters"},/turf/open/floor/plating,/area/space)
"kF" = (/obj/structure/surface/rack,/obj/item/stack/sheet/cardboard{amount = 50; pixel_x = -3},/obj/item/stack/sheet/cardboard{amount = 50; pixel_x = 4},/turf/open/floor/almayer{icon_state = "plate"; tag = "icon-sterile"},/area/space)
"lr" = (/obj/structure/largecrate/random/secure,/obj/item/ammo_box/magazine/m44/heavy/empty{layer = 3.0; pixel_y = 10},/turf/open/floor/plating/plating_catwalk,/area/space)
"mL" = (/obj/structure/barricade/wooden{dir = 4},/obj/structure/largecrate/random/barrel/red{pixel_x = -4},/turf/open/floor/plating/plating_catwalk,/area/space)
"nW" = (/obj/structure/closet/secure_closet/guncabinet/blue{name = "sidearm storage"},/obj/item/weapon/gun/pistol/m4a3,/turf/open/floor/almayer{dir = 5; icon_state = "plating"; tag = "icon-blue (NORTHEAST)"},/area/space)
"oS" = (/obj/structure/surface/table/almayer,/obj/item/storage/box/handcuffs{pixel_x = -8; pixel_y = 11},/obj/item/storage/box/handcuffs{pixel_x = 4; pixel_y = 10},/obj/item/storage/box/guncase/shotguncombat,/turf/open/floor/plating/almayer,/area/space)
"pd" = (/obj/structure/machinery/vending/cigarette{density = 0; pixel_y = 16},/obj/structure/largecrate,/turf/open/floor/plating/plating_catwalk,/area/space)
"pE" = (/obj/structure/machinery/light/small{dir = 8},/obj/structure/barricade/deployable{dir = 1},/obj/item/prop/helmetgarb/spent_buckshot{pixel_x = 7; pixel_y = -9},/turf/open/floor/almayer{icon_state = "plate"; tag = "icon-sterile"},/area/space)
"pI" = (/turf/template_noop,/area/template_noop)
"qI" = (/obj/structure/closet/secure_closet/guncabinet/blue{name = "sidearm storage"},/obj/item/ammo_magazine/pistol,/obj/item/ammo_magazine/pistol,/obj/item/ammo_magazine/pistol,/obj/item/ammo_magazine/pistol,/obj/structure/machinery/light{dir = 8},/obj/item/weapon/gun/pistol/m4a3/unloaded,/turf/open/floor/almayer{dir = 5; icon_state = "plating"; tag = "icon-blue (NORTHEAST)"},/area/space)
"qO" = (/obj/item/tool/weldingtool/simple{pixel_x = 9; pixel_y = -3},/turf/open/floor/almayer{icon_state = "plate"; tag = "icon-sterile"},/area/space)
"qP" = (/obj/effect/decal/warning_stripes{icon_state = "S"; tag = "icon-S"},/turf/open/floor/almayer{dir = 5; icon_state = "plating"; tag = "icon-blue (NORTHEAST)"},/area/space)
"rl" = (/obj/structure/machinery/washing_machine,/obj/structure/machinery/light/small{dir = 4},/turf/open/floor/almayer{icon_state = "plate"; tag = "icon-sterile"},/area/space)
"sg" = (/obj/structure/largecrate/random/case/small{pixel_y = 11},/obj/item/ammo_box/magazine/misc/mre/empty{layer = 3.0; pixel_x = 8},/obj/item/ammo_box/magazine/misc/mre{layer = 3.0; pixel_x = -6},/turf/open/floor/plating/plating_catwalk,/area/space)
"to" = (/obj/structure/surface/table/almayer{dir = 1; flipped = 1},/obj/item/weapon/gun/shotgun/pump,/obj/item/ammo_box/magazine/shotgun/buckshot/empty{pixel_y = 7; pixel_x = 4},/turf/open/floor/almayer{icon_state = "plate"; tag = "icon-sterile"},/area/space)
"ts" = (/obj/structure/largecrate/random/secure,/turf/open/floor/plating/plating_catwalk,/area/space)
"tN" = (/obj/structure/machinery/light/small,/obj/structure/barricade/metal{dir = 4},/turf/open/floor/plating/plating_catwalk,/area/space)
"xM" = (/obj/structure/surface/table/almayer{dir = 1; flipped = 1},/turf/open/floor/plating/plating_catwalk,/area/space)
"yp" = (/obj/structure/machinery/light/small{dir = 1; tag = "icon-bulb1 (NORTH)"},/turf/open/floor/plating/plating_catwalk,/area/space)
"zc" = (/obj/structure/largecrate/random/barrel/green,/turf/open/floor/plating/plating_catwalk,/area/space)
"AA" = (/obj/structure/surface/table/almayer,/obj/structure/machinery/cm_vending/sorted/medical/wall_med{pixel_y = 25},/obj/item/storage/firstaid/adv/empty{pixel_x = 7; pixel_y = 9},/obj/item/clothing/head/helmet/marine/MP{pixel_x = -8},/turf/open/floor/plating/almayer,/area/space)
"Bk" = (/obj/structure/largecrate/random/case/double,/turf/open/floor/plating/plating_catwalk,/area/space)
"CK" = (/obj/structure/bedsheetbin,/turf/open/floor/plating/plating_catwalk,/area/space)
"CP" = (/obj/structure/machinery/light/small,/obj/structure/barricade/plasteel{dir = 8},/turf/open/floor/plating/plating_catwalk,/area/space)
"Db" = (/obj/effect/decal/warning_stripes{icon_state = "S"; tag = "icon-S"},/obj/structure/barricade/deployable{dir = 8},/turf/open/floor/almayer{dir = 5; icon_state = "plating"; tag = "icon-blue (NORTHEAST)"},/area/space)
"EA" = (/turf/open/floor/plating/plating_catwalk,/area/space)
"Gp" = (/obj/structure/surface/table/almayer,/obj/item/storage/fancy/cigarettes/emeraldgreen{pixel_x = -10; pixel_y = 13},/obj/item/reagent_container/food/drinks/flask/marine{pixel_x = 10; pixel_y = 11},/obj/item/trash/USCMtray{pixel_y = 2},/turf/open/floor/almayer{icon_state = "plate"; tag = "icon-sterile"},/area/space)
"Id" = (/obj/structure/closet/secure_closet/guncabinet/red,/obj/item/clothing/suit/storage/marine/MP,/obj/item/clothing/suit/storage/marine/MP,/turf/open/floor/plating/almayer,/area/space)
"IF" = (/obj/item/tool/mop{pixel_x = -6; pixel_y = 14},/obj/effect/decal/cleanable/blood/gibs/xeno,/turf/open/floor/almayer{icon_state = "plate"; tag = "icon-sterile"},/area/space)
"Jo" = (/obj/structure/largecrate/supply{pixel_x = 6},/obj/structure/largecrate/random/mini/ammo{pixel_x = 5; pixel_y = 12},/obj/structure/barricade/deployable{dir = 8},/turf/open/floor/plating/plating_catwalk,/area/space)
"JF" = (/obj/structure/machinery/firealarm{pixel_y = 28},/obj/structure/gun_rack/m20a/empty,/turf/open/floor/plating/almayer,/area/space)
"KN" = (/obj/item/tool/crowbar,/turf/open/floor/plating/plating_catwalk,/area/space)
"LF" = (/obj/structure/barricade/plasteel{dir = 1},/turf/open/floor/almayer{icon_state = "plate"; tag = "icon-sterile"},/area/space)
"Mc" = (/turf/closed/wall/almayer,/area/space)
"Ml" = (/obj/structure/closet/secure_closet/guncabinet/riot_control,/obj/item/weapon/shield/riot/metal,/turf/open/floor/plating/almayer,/area/space)
"Nm" = (/obj/structure/prop/invuln/overhead_pipe{pixel_x = 12},/turf/open/floor/almayer{icon_state = "plate"; tag = "icon-sterile"},/area/space)
"NU" = (/obj/structure/barricade/wooden{dir = 4},/turf/open/floor/plating/plating_catwalk,/area/space)
"Od" = (/obj/structure/machinery/light/small{dir = 8; tag = "icon-bulb1 (WEST)"},/obj/structure/gun_rack/mk221/empty{pixel_x = 10},/obj/structure/gun_rack/mk221{pixel_x = -8},/turf/open/floor/plating/almayer,/area/space)
"Or" = (/turf/open/floor/almayer{icon_state = "plate"; tag = "icon-sterile"},/area/space)
"OV" = (/obj/structure/sink{dir = 8; pixel_x = -12; pixel_y = 2},/turf/open/floor/almayer{icon_state = "plate"; tag = "icon-sterile"},/area/space)
"Pi" = (/obj/structure/largecrate/supply/supplies/water,/turf/open/floor/plating/plating_catwalk,/area/space)
"Qc" = (/obj/structure/prop/invuln/overhead_pipe{pixel_x = 12},/turf/open/floor/plating/plating_catwalk,/area/space)
"TU" = (/turf/closed/wall/almayer/outer,/area/space)
"Uz" = (/obj/structure/machinery/vending/security,/turf/open/floor/plating/almayer,/area/space)
"UJ" = (/obj/structure/machinery/door/airlock/almayer/security/glass{name = "\improper Millitary Police Armory"},/obj/structure/machinery/door/poddoor/shutters/almayer{dir = 4; id = "bot_armory"; name = "\improper Armory Shutters"},/turf/open/floor/plating,/area/space)
"UW" = (/obj/structure/machinery/door/airlock/almayer/maint{dir = 2},/turf/open/floor/almayer{icon_state = "plate"; tag = "icon-sterile"},/area/space)
"Ve" = (/obj/structure/closet/crate/ammo{pixel_y = 13},/obj/structure/largecrate/random/case/small,/obj/structure/largecrate/random/mini/med{pixel_y = 10},/turf/open/floor/plating/plating_catwalk,/area/space)
"VO" = (/obj/structure/closet/secure_closet/guncabinet/riot_control,/obj/item/clothing/head/helmet/marine/MP,/obj/item/clothing/head/helmet/marine/MP,/obj/item/prop/helmetgarb/riot_shield{pixel_y = -3},/turf/open/floor/plating/almayer,/area/space)
"VQ" = (/obj/structure/bed/chair{dir = 8; pixel_y = 3},/turf/open/floor/plating/plating_catwalk,/area/space)
"Xp" = (/turf/open/floor/almayer{dir = 5; icon_state = "plating"; tag = "icon-blue (NORTHEAST)"},/area/space)
"Yd" = (/obj/structure/machinery/door/airlock/almayer/maint{dir = 1},/turf/open/floor/almayer{icon_state = "test_floor4"},/area/space)
"YA" = (/obj/structure/closet/firecloset{pixel_x = 13},/obj/structure/bed/chair{dir = 8; pixel_x = -5; pixel_y = 3},/turf/open/floor/plating/plating_catwalk,/area/space)

(1,1,1) = {"
pIpIpIpIpIpIpIpIpIpIpIpIpIpIpIpIMcMcUWMcMcMcMcMcMcMcpIpI
pIpIpIpIpIpIpIpIpIpIpIpIpIpIpIpIMcIFglkFMcoSAAUzJFkCpIpI
pIpIpIpIpIpIpIpIpIpIpIpIpIpIpIpIMcOVzcrlMcnWXpXpXpkCpIpI
pIpIpIpIpIpIpIpIpIpIpIpIpIpIpIpIMcpExMtoMcqIXpXpXpUJpIpI
pIpIpIpIpIpIpIpIpIpIpIpIpIpIpIpIMcOrOrqOaDDbqPqPqPMcpIpI
pIpIpIpIpIMcMcMcMcMcMcMcMcMcMcMcMcMcUWMcMcOdIdVOMlkCpIpI
McMcMcMcMcMcGpVQfCsgbzEAypQcBkKNlrCKLFMcMcMcMcMcMcMcMcMc
JoPiedEAEACPieEAOrOrOrOrOrNmOrOrOrEAEAtNEAEANUpdVeYAtsmL
TUTUTUTUTUTUTUTUTUTUTUTUYdTUTUTUTUTUTUTUTUTUTUTUTUTUTUTU
"}
